XXXXXX
X_gXXX
XXrXXX
X____X
X__b_X
X__XXX
XXXXXX
