XXXXXXX
XXX__XX
XXXb_XX
X_b__RX
X_ggg_X
XXb__XX
XX__XXX
XXXXXXX
