XXXXXXXXXXX
XXXXXXXA__X
XXXXXXXBX_X
XXXXXXXCX_X
X_r_c_b_a_X
X_X_X_X_XXX
X_______XXX
XXXXXXXXXXX
