XXXXXX
X_gXXX
XXrXXX
X____X
X__o_X
X__XXX
XXXXXX
