XXXXXX
XA__XX
Xrab_X
XX___X
XXX__X
XXXX_X
XXXXBX
XXXXXX
